world,door,level,levelData
1,1,1,3x1;111
1,1,2,3x3;111;010;111
1,1,3,3x2;101;101
1,1,4,2x4;01;01;10;10
1,2,1,3x3;101;010;101
1,2,2,4x3;1101;1101;1101
